AB - подушка безопасности;
ABS - антиблокировочная система;
AC - система кондиционирования;
ASP - наружное зеркало заднего вида;
AТ - автоматическая коробка передач;
AZV - прицепное устройство;
CC - система контроля неисправно­стей;
CD - CD-чейнджер;
CRC - круиз-контроль;
D - дизельный двигатель;
DS - противоугонное устроуство;
DT - дизельный двигатель с турбо­наддувом X25DT;
DTH - дизельный двигатель с турбо- наддувом X20DTH;
DWA - противоугонная система;
DZM - тахометр;
ECC - электронная система климат- контроля;
EKP - топливный насос;
EMP - радиоприемник;
FH - электрические стеклоподъем­ники;
FIN - модель в комплектации для Финляндии;
GB - модель в комплектации для Bе­ликобритании;
HS - обогреватель заднего стекла;
HSF - вещевой ящик;
HKL - гидроусилитель рулевого уп­равления;
HRL - лампа освещения багажного отделения;
HZG - отопление;
ID - информационный дисплей;
IMO - иммобилайзер;
INS - панель приборов;
IRL - лампы освещения салона авто­мобиля, включающиеся при открыва­нии дверей;
IRLT - лампы освещения салона ав­томобиля;
J - модель в комплектации для Япо­нии;
KAТ - каталитический нейтрализатор отработавших газов;
KBS - жгут проводов;
KW - кузов типа универсал;
LED - светодиод;
LHD - левостороннее расположение рулевого управления;
MID - многофункциональный дисплей;
MТ - механическая коробка передач;
N - модель в комплектации для Нор­вегии;
NS - лампы противотуманного света фар;
NSL - лампы противотуманного све­та задних фонарей;
OEL - система контроля уровня/ дав­ления масла;
PBSL - блокировка в положении «Парковка/ Тормоз» (автоматическая коробка передач);
P/N - «Парковка/ Нейтральная переда­ча» (автоматическая коробка передач);
RFS - лампы света заднего хода;
RHD - правостороннее расположе­ние рулевого управления;
S - модель в комплектации для Шве­ции;
SA - модель в комплектации для Cа­удовской Aравии;
SD - люк;
SH - обогреваемые сиденья;
SM - ЭБУ двигателем;
SRA - очиститель и омыватель фар;
ТC - противобуксовочная система (traction control);
TD - дизельный двигатель с турбо- наддувом;
TEL - телефон;
TFL - система включения ближнего света фар в дневное время;
TID - трехпозиционный информаци­онный дисплей;
TKS - контактный выключатель на двери;
WEG - датчик одометра;
WD - сопло омывателя;
WS - предупредительный зуммер;
ZIG - прикуриватель;
ZV - центральный замок;
